000000000000000000000000000000000000000000000000000000000000
000000000000000000000000000000000000000000000000000000000000
000111111111110111111111111111000000000000000000000000000000
000133333333310133333331133451000000000000000000000111111000
000133334333311131111131131111000011111111111100000133331000
000133333333323331000131131000000015333333333100000131131000
000133343333311111000131131000000011111111113100000131131000
000111111121110000000133331000000000000000013100000131131000
000000000131000000000111111000111111111110013100000131131000
000000000131000000000000000000134333333310013100000131131000
000000111131111111111110011111133343343310013100000131131000
000000133333333333333311113323333333333310013100000131131000
000000133333333343333323333311111133433310013111111131131000
000000133433333333333311113310000133333510013333333331131000
000000133334333334543310012110000111121110013111111111131000
000000133333333334443310013100000000131000013114333333331000
000000133333334333333310013111111011131100013111111111111000
000000133333333333333310013233331013335100113110000000000000
000000111111111111111110013111131013433111133310000000000000
000011111110000000000000013100131113333233333310111111100000
000013333510000000000000013100133333433111111210133333111000
000013111110000001111111113100111111111100001311131113341000
000013100011111111333333333100000000000000001333331011111000
000013100013333332333333555100000000000000001111111000000000
000013100014311111333335555100000000000000000000000000000000
000013100013310001111111112111111111000000000000000000000000
000013100013410000000000013113343351111111111111000000000000
000013100013110000000000013333343442333333333331000000000000
000013100013111111111000013334333111111131111131000000000000
000013100013333333331000013433333111000131000131000000000000
000013100011343333331000013333433441000131111131000000000000
000013100001133343111000013343333351000133333451000000000000
000013111111113111100000011211111111000111111111011110000000
000013333333333100000000001310000000000000000000015311000000
000011111111111100000000001310000011111111000000011331100000
000000000000000000000000001310000113333431000000001133100000
000000000000000000000000001310001133433311000000000113100000
000000111111110000000000001310011333333110000000001133100000
000000155555510000000000001310013343331100000000011331100000
000000155555511111111111111311111112111111111111113311000000
000000155555523333333333333333333333333333333333333110000000
000000155555511111112111111111111211111111111111111100000000
000000155555510011113111100000001310000000000001110000000000
000000111111110014443444100000001311111111111101410000000000
000000000000000014443444100000001323333333333101311111111000
000111111100000014444444100000001311111113113233333332341000
000153333100000015555555100000001310000013333111311111111000
000111113100000011111111100000001310000011111101510111000000
000000015111111111111111111111111311111110000001110151011100
000000013333353333353333533353333333333310000000000131014100
000000011211111111111111111111111111111311111111110131013100
000000001300000000000000001111110000001333353333310131013100
001111111311111111000000011555511110001153433334311131013100
001343333533333331111110013555555510000133334343333331013100
001133433333343333353311115555555110000134333333311111013100
000111111333333343333323333533151111111111111111111111113100
000000001134333333335111115555155555233333333333333333333100
000000000111111111111100011111111111111111111111111111111100
000000000000000000000000000000000000000000000000000000000000
000000000000000000000000000000000000000000000000000000000000
