000000000000000000000000000000000000000000000000000000000000
000000000000000000000000000000000000000000000000000000000000
000111111111110111111111111111000000000000000000000000000000
000133333333310133333331133331000000000000000000000000000000
000133334333311131111131131111000000000000000000000000000000
000133333333323331000131131000000000000000000000000000000000
000133343333311111000131131000000000000000000000000000000000
000111111121110000000133331000000000000000000000000000000000
000000000131000000000111111000111111111110000000000000000000
000000000131000000000000000000134333333310000000000000000000
000000111131111111111110011111133343343310000000000000000000
000000133333333333333311113323333333333310000000000000000000
000000133333333343333323333311111133433310000000000000000000
000000133433333333333311113310000133333510000000000000000000
000000133334333334543310012110000111111110000000000000000000
000000133333333334443310013100000000000000000000000000000000
000000133333334333333310013111111011111100000000000000000000
000000133333333333333310013233331013335100000000000000000000
000000111111111111111110013111131013433100000000000000000000
000011111110000000000000013100131113333100000000000000000000
000013333510000000000000013100133333433100000000000000000000
000013111110000001111111113100111111111100000000000000000000
000013100011111111333333333100000000000000000000000000000000
000013100013333332333333333100000000000000000000000000000000
000013100014311111333333333100000000000000000000000000000000
000013100013310001111111111100000000000000000000000000000000
000013100013410000000000000000000000000000000000000000000000
000013100013110000000000000000000000000000000000000000000000
000013100013111111111000000000000000000000000000000000000000
000013100013333333331000000000000000000000000000000000000000
000013100011343333331000000000000000000000000000000000000000
000013100001133343111000000000000000000000000000000000000000
000013111111113111100000000000000000000000000000000000000000
000013333333333100000000000000000000000000000000000000000000
000011111111111100000000000000000000000000000000000000000000
000000000000000000000000000000000000000000000000000000000000
000000000000000000000000000000000000000000000000000000000000
000000000000000000000000000000000000000000000000000000000000
000000000000000000000000000000000000000000000000000000000000
000000000000000000000000000000000000000000000000000000000000
000000000000000000000000000000000000000000000000000000000000
000000000000000000000000000000000000000000000000000000000000
000000000000000000000000000000000000000000000000000000000000
000000000000000000000000000000000000000000000000000000000000
000000000000000000000000000000000000000000000000000000000000
000000000000000000000000000000000000000000000000000000000000
000000000000000000000000000000000000000000000000000000000000
000000000000000000000000000000000000000000000000000000000000
000000000000000000000000000000000000000000000000000000000000
000000000000000000000000000000000000000000000000000000000000
000000000000000000000000000000000000000000000000000000000000
000000000000000000000000000000000000000000000000000000000000
000000000000000000000000000000000000000000000000000000000000
000000000000000000000000000000000000000000000000000000000000
000000000000000000000000000000000000000000000000000000000000
000000000000000000000000000000000000000000000000000000000000
000000000000000000000000000000000000000000000000000000000000
000000000000000000000000000000000000000000000000000000000000
000000000000000000000000000000000000000000000000000000000000
000000000000000000000000000000000000000000000000000000000000
